%%%%%%%
%    P%
%%%%% %
%. %  %
%%   %%
%  %%%%
%%%%%%%
